会派名と略称の時点,会派名,略称,議員数の時点,議員数,議員数／女性,任期1／任期満了,任期1／比例,任期1／比例／女性,任期1／選挙区,任期1／選挙区／女性,任期1／合計,任期1／合計／女性,任期2／任期満了,任期2／比例,任期2／比例／女性,任期2／選挙区,任期2／選挙区／女性,任期2／合計,任期2／合計／女性
2025-08-01,自由民主党,自民,2025-09-25,100,19,2028-07-25,18,5,43,7,61,12,2031-07-28,12,3,27,4,39,7
2025-08-01,立憲民主・社民・無所属,立憲,2025-09-25,42,21,2028-07-25,8,5,10,5,18,10,2031-07-28,8,4,16,7,24,11
2025-08-01,国民民主党・新緑風会,民主,2025-09-25,25,8,2028-07-25,3,0,4,3,7,3,2031-07-28,7,1,11,4,18,5
2025-08-01,公明党,公明,2025-09-25,21,2,2028-07-25,6,0,7,2,13,2,2031-07-28,4,0,4,0,8,0
2025-08-01,日本維新の会,維新,2025-09-25,19,7,2028-07-25,8,3,4,1,12,4,2031-07-28,4,2,3,1,7,3
2025-08-01,参政党,参政,2025-09-25,15,7,2028-07-25,1,0,0,0,1,0,2031-07-28,7,2,7,5,14,7
2025-08-01,日本共産党,共産,2025-09-25,7,3,2028-07-25,3,1,1,0,4,1,2031-07-28,2,1,1,1,3,2
2025-08-01,れいわ新選組,れ新,2025-09-25,6,2,2028-07-25,2,0,1,0,3,0,2031-07-28,3,2,0,0,3,2
2025-08-01,日本保守党,保守,2025-09-25,2,0,2028-07-25,0,0,0,0,0,0,2031-07-28,2,0,0,0,2,0
2025-08-01,沖縄の風,沖縄,2025-09-25,2,1,2028-07-25,0,0,1,0,1,0,2031-07-28,0,0,1,1,1,1
2025-08-01,各派に属しない議員,無所属,2025-09-25,9,4,2028-07-25,1,0,3,1,4,1,2031-07-28,1,0,4,3,5,3
